+ + + + + + + + + + + +
+ - - % X - - X - - - +
+ X - - - - - @ @ - - +
+ - @ - - @ - - X @ - +
+ + - - - - - - - - - +
+ + + + + + + + + + + +
